#########  E   ##########
########### #############
#                      ##
#                      ##
####################   ##
#                       #
#                       #
#                       #
#                       #
#                       #
#                       #
#                       #
#########  S   ##########
#########################