#######################
#                     #
# ################### #
# #     #         # # #
# ##### # ### # ### # #
# #     #   # #   # # #
# # ####### # # # # # #
# # S        # # #   ##
### ##### # # ##### # #
# # #   # # # #     # #
# # ### #E### ##### # #
# #   # # # # #     # #
# # # # ### ### # # # #
# # #   #   #   # # # #
# # ####### ### ### # #
# # #           #   # #
# # ### ##### ##### # #
# # # #   #   #   # # #
# # # ### # # # # # # #
# #       # #   # # # #
# ################### #
#                     #
#######################
#######################