#######
#  E  #
### ###
#     #
#     #
#     #
#     #
#     #
#     #
#     #
#  #  #
##### #
# ### #
#  #  #
#     #
#### ##
## # ##
#  S  #
#######